##############
#   #        #
# . #  ##### #
#      #  ## #
######### #  #
#         # ##
# ######  #  #
#   #  # ### #
#   #        #
##############


























































































