##############
#   #........#
# A #. #####.#
# .... #  ##.#
######### #..#
#       .B#.##
# ######. #..#
#   #  #.###.#
#   #   .....#
##############


























































































